R, R, R, R, R,
R, C-a, C, C, R,
R, C, R, C, R,
R, R, R, M, R,
R, C, C, C, R,
R, C, C, C, R,
R, R, R, R, R,